{
    "切": 3,
    "する": 1,
    "加え": 4,
    "茹で": 1,
    "使用": 1,
    "温め": 1,
    "加え刻": 1,
    "炒め": 1,
    "調え": 1,
    "盛り付け": 1,
    "かけ": 1,
    "入れ": 1,
    "注意": 1
}