{
    "切": 2,
    "わけ": 1,
    "する": 1,
    "かけ": 1,
    "注": 1,
    "温め": 1,
    "加え": 4,
    "炒め": 3,
    "入れ": 1,
    "振": 1,
    "止め": 1,
    "盛り付け": 1
}