{
    "こす": 1,
    "落と": 1,
    "し": 1,
    "茹で": 1,
    "切": 1,
    "する": 1,
    "入れ": 1,
    "加え": 2,
    "和え": 1,
    "混ぜ": 1,
    "盛り付け": 1
}