{
    "入れ": 3,
    "かけ": 1,
    "煮る": 1,
    "止め": 1,
    "急冷": 1,
    "仕上が": 1,
    "盛り付け": 1
}