{
    "し": 1,
    "戻": 1,
    "入れ": 1,
    "かけ": 1,
    "加え": 1,
    "ひと": 1,
    "溶か": 1,
    "止め": 1,
    "よそ": 1,
    "散ら": 1
}