{
    "洗": 1,
    "する": 1,
    "入れ": 1,
    "かけ": 1,
    "加え": 1,
    "よそ": 1,
    "散ら": 1
}