{
    "ぶな": 2,
    "と": 1,
    "ほぐ": 1,
    "する": 1,
    "入れ": 1,
    "熱": 1,
    "加え": 3,
    "混ぜ": 1,
    "炒め": 1,
    "絡め": 1,
    "止め": 1,
    "置": 1,
    "なじ": 1,
    "盛り付け": 1
}