{
    "下ろ": 1,
    "除去": 1,
    "し": 2,
    "焼": 1,
    "さば": 1,
    "使用": 1,
    "ぶな": 2,
    "切り落と": 1,
    "ほぐ": 2,
    "入れ": 1,
    "かけ": 2,
    "加え": 1,
    "止め": 1,
    "盛り付け": 1,
    "載せ": 1,
    "添え": 1
}