{
    "する": 1,
    "入れ": 1,
    "かけ": 1,
    "調え": 1,
    "止め": 1,
    "注": 1,
    "散ら": 1
}